,Unnamed: 0,Student's ID,Name,Midterm Grade,Classwork Grad,Final scores
0,,740550,Ahmed,70,91,161
1,,685507,Mohamed,65,72,137
2,,748785,Rose,40,55,95
3,,493869,Joe,91,84,175
4,,489221,Michael,88,74,162
5,,403568,Nora,78,89,167
6,,328328,Sarah,96,81,177
7,,441059,Ali,52,48,100
8,,898954,Anna,66,70,136
9,,739768,Carl,97,90,187
